1943|1943 - The Battle of Midway
3 DConstruction Kit|3D Construction Kit
3 DPool|3D Pool
3 DGalax|3D Galax
3001 OConnors Fight|3001 O'Connor's Fight
3 DWorld Boxing|3D World Boxing 
3 DWorld Soccer|3D World Soccer 
3 DWorld Tennis|3D World Tennis 
4 DSports Boxing|4D Sports Boxing
4 DSports Driving|4D Sports Driving
4 DSports Driving & Mstr Trcks|4D Sports Driving (& Master Tracks)
Aaargh! Arcadia|Aaargh! (Arcadia)
A BCMonday Night Football|ABC Monday Night Football 
Aot GSA FP 27b 6|Attack of the Green Smelly Aliens from Planet 27b-6
Raiders 01|Raiders-01
A V 8 BHarrier Assault|AV8B Harrier Assault
& Mstr Trcks|(Master Tracks)
Abandoned Places|Abandoned Places - A Time for Heroes
3DAGA|3D AGA
Academy|Academy - Tau Ceti II
Advanced Destroyer Sim|ADS - Advanced Destroyer Simulator
4x 4 Off Road Racing|4X4 Off-Road Racing
A 10 Tank Killer (3 Disk)|A-10 Tank Killer (3 Disk)
A 10 Tank Killer (2 Disk)|A-10 Tank Killer (2 Disk)
A PBImage|APB (Image)
A Train|A-Train
A Train & Construction Set|A-Train (& Construction Set)
A TF 2|ATF II - Advanced Tactical Fighter II
AGAFixed|AGA (Fixed)
AGE|A.G.E. (Advanced Galactic Empire)
Alien Breed Story|Alien Breed (Story)
Allan Borders Cricket|Allan Border's Cricket
Alpha 1|Alpha-1
All Terrain Racing|ATR - All Terrain Racing
Another World Lost Level|Another World (Lost Level)
Apidya Audios|Apidya (Audios)
Apidya Kaiko|Apidya (Kaiko)
Blasta Ball Arcadia|BlastaBall (Arcadia)
Delta Command Arcadia|Delta Command (Arcadia)
Fast Break Arcadia|Fast Break (Arcadia)
Pharaoh's Match Arcadia|Pharaoh's Match (Arcadia)
Space Ranger Arcadia|Space Ranger (Arcadia)
Table Hockey Arcadia|Table Hockey (Arcadia)
Ten Pin Bowling Arcadia|Ten Pin Bowling (Arcadia)
World Trophy Soccer Arcadia|World Trophy Soccer (Arcadia)
Aquanaut F 1 Licenceware|Aquanaut (F1 Licenceware)
Archer Macleans Billard Amcn|Archer Macleans's Le Billard Americain
Archer Mac Leans Pool|Archer MacLean's Pool
ArkanoidReve|Arkanoid - Reve
Arkanoid Revenge Of Doh|Arkanoid - Revenge Of Doh
Armalyte|Armalyte - The Final Run
Armour Geddon|Armour-Geddon
Armour Geddon 2|Armour-Geddon II - Codename Hellfire
Asterix Op Getafix|Asterix - Operation Getafix
Astaroth|Astaroth - The Angel of Death
Alien Breed 2|Alien Breed II - The Horror Continues
Alien Breed 2 [AGA]|Alien Breed II - The Horror Continues [AGA]
Alien Drug Lords|Alien Drug Lords - The Chyropian Connection
A TF2|Advanced Tactical Fighter II
ATF2|Advanced Tactical Fighter II
APBImage|APB (Image)
Atomic Robo Kid|Atomic Robo-Kid
Axels Magic Hammer|Axel's Magic Hammer
Arena|Arena (Psygnosis)
Beneath A Stl Sky|Beneath a Steel Sky
Alien Breed Special Edition|Alien Breed Special Edition '92
Alien Breed TA|Alien Breed - Tower Assault
Allo Allo|Allo Allo! Cartoon Fun!
Aquatic Games|Aquatic Games - Starring James Pond and the Aquabats
Archon|Archon - The Light and the Dark
Archon 2|Archon II - Adept
After Burner Activision|After Burner (Activision)
After Burner Sega|After Burner (Sega)
Destroyer Sim|Destroyer Simulator
Bubble & Squeak|Bubble and Squeak
Bubble & Squeak [AGA]|Bubble and Squeak [AGA]
B 17 Flying Fortress|B-17 Flying Fortress
B AT|BAT
BA T|B.A.T.
BA T 2|B.A.T. II
Bad Dudes Vs Dragon Ninja|Bad Dudes vs. DragonNinja
Baby Jo In Going Home|Baby Jo - Going Home
Balance Of Power|Balance of Power - Geopolitics in the Nuclear Age
Balance Of Power 1990 Ed|Balance of Power - The 1990 Edition
Bandit Kings|Bandit Kings of Ancient China
Barbarian Palace|Barbarian - The Ultimate Warrior
Barbarian Psygnosis|Barbarian (Psygnosis)
Barbarian 2 Palace|Barbarian II - The Dungeon of Drax
Barbarian 2 Psygnosis|Barbarian 2 (Psygnosis)
Bards Tale|Bard's Tale - Tales of the Unknown
Bards Tale 2|Bard's Tale II - The Destiny Knight
Bards Tale 3|Bard's Tale III - Thief of Fate
Bart Vs Sp Mutants|Bart Vs The Space Mutants
Bart Vs Space Mutants (2 Disk)|Simpsons - Bart Vs The Space Mutants (2 Disk)
Bart Vs The World|Simpsons - Bart Vs The World
Batman Caped Crusader|Batman - The Caped Crusader
Batman The Movie|Batman - The Movie
Battle Isle & Data Disks|Battle Isle (& Data Disks)
Battle Chess 2|Battle Chess II - Chinese Chess
Battle For Ashes|Battle For The Ashes
Battletech|BattleTech - The Crescent Hawk's Inception
Best Of The Best|Best Of The Best - Championship Karate
BCKid|BC Kid
Block Shock|Block Shock - The Last Chance
Blood Net|BloodNet - A Cyberpunk Gothic
Blood Net [AGA]|BloodNet - A Cyberpunk Gothic [AGA]
Bloodwych & Extended Levels|Bloodwych (& Extended Levels)
Blinkys Scary School|Blinky's Scary School
Black Goldre LINE|Black Gold (reLINE)
Bills Tomato Game|Bill's Tomato Game
Blue Angels|Blue Angels - Formation Flight Simulation
Blue Max|Blue Max - Aces of the Great War
BMXSimulator|BMX Simulator
Bobs Bad Day|Bob's Bad Day
Bobs Garden|Bob's Garden
Borobodur|Borobodur - The Planet of Doom
Boulder Dash Constr Kit|BoulderDash Construction Kit
Brian Laras Cricket|Brian Lara's Cricket
Brian Laras Cricket 96|Brian Lara's Cricket '96
BSSJane Seymour|BSS Jane Seymour
Bubba NStix|Bubba'N'Stix
Bubble +|Bubble +
Buffalo Bills Wild West Show|Buffalo Bill's Wild West Show
Buck Rogers Countdown Dday|Buck Rogers - Countdown To Doomsday
Budokan|Budokan - The Martial Spirit
Builderland|Builderland - The Story of Melba
Bundesliga Manager Hatt|Bundesliga Manager Hattrick
Bump NBurn|Bump 'N' Burn
Cabaret Asteroids Repacked|Cabaret Asteroids
Cadaver & Cadaver The Payoff|Cadaver (& The Pay Off)
Cadaver The Payoff|Cadaver - The Pay Off
 & Data Disk| (& Data Disk)
Cannon Fodder 2 Alien Levels|Cannon Fodder 2 (Alien Levels)
Cannon Fodder New Campaign|Cannon Fodder (New Campaign)
Campaign & Data Disk|Campaign (& Data Disk)
Cap NCarnage|Cap 'n' Carnage
Car Vup|CarVup
Cardiaxx Electronic Zoo|Cardiaxx (Electronic Zoo)
Cardiaxx Team 17|Cardiaxx (Team 17)
Carrier Command No Music|Carrier Command (No Music)
Castle Vania|Castlevania
Chamber Sci Mutant Priestess|Chamber Of The Sci-Mutant Priestess
Chaos Strikes Back & En Util|Chaos Strikes Back (& Utility Disk)
Chaos Strikes Back & De Util|Chaos Strikes Back (& Utility Disk) (Deutsch)
Chaos Strikes Back & Fr Util|Chaos Strikes Back (& Utility Disk) (Francais)
Charlie JCool|Charlie J. Cool
Chrono Quest 2|Chrono Quest II
Chase HQ|Chase H.Q.
Chase HQ 2|Chase H.Q. II
Classic & Baby Arcadia|Classic Arcadia & Baby Arcadia
Clue|Clue, The
Crackdown|Crack Down
Centrefold Squares|Centerfold Squares
Chips Challenge USGold|Chips Challenge (US Gold)
Chips Challenge Epyx|Chips Challenge (Epyx)
Chuck Yeagers A FT 2|Chuck Yeager's Advanced Flight Trainer 2.0
CJIn The USA|CJ In The USA
Clown OMania|Clown O'Mania
Chrono Quest 2|Chrono Quest II
Computer Third Reich|Third Reich
Conflict Middle East Pol Sim|Conflict - The Middle East Simulation
Conflict Europe|Conflict - Europe
Corporation & Missions (3 Disk)|Corporation (& Mission Disk) (3 Disk)
Crazy Cars 3 No Intro|Crazy Cars 3 (No Intro)
Cross Check|CrossCheck
Crystal Hammer V 1|Crystal Hammer (V1)
Crystal Hammer V 2|Crystal Hammer (V2)
Crossbow Legend William Tell|Crossbow - The Legend of William Tell
Cybernoid 2|Cybernoid II
Cybernoid|Cybernoid - The Fighting Machine
Daley Thompsons OC (2 Disk)|Daley Thompson's Olympic Challenge (2 Disk)
Daley Thompsons OC (3 Disk)|Daley Thompson's Olympic Challenge (3 Disk)
Darius +|Darius+
Dark Spyre|DarkSpyre
Damage Preview|Damage (Preview)
DDay Impressions|D-Day (Impressions)
Death Bringer Spotlight|Deathbringer (Spotlight)
Deathbringer Empire|Deathbringer - The Sword Of Abaddon (Empire)
Defender Ratsoft|Defender (Ratsoft)
Defender 2|Defender II
Deluxe Strip Poker 2 & DDisks|Deluxe Strip Poker 2 (& Data Disks)
Demons Tomb The Awakening|Demon's Tomb - The Awakening
DGeneration|D-Generation
Dream Web|DreamWeb
Dick Tracy Adventure|Dick Tracy (Adventure)
Discovery Micro Illusions|Discovery (MicroIllusions)
Discovery|Discovery - In The Steps of Columbus
Dizzys Excellent Adventures|Dizzy's Excellent Adventures
Dizzy Prince Of The Yolkfolk|Dizzy - Prince Of The Yolkfolk
Donalds Alphabet Chase|Donald's Alphabet Chase
Dr Dooms Revenge (1 Disk)|Dr Doom's Revenge (1 Disk)
Dragons Lair|Dragon's Lair
Dragons Lair Escape (Fast)|Dragon's Lair - Escape From Singe's Castle (Fast)
Dragons Lair Escape|Dragon's Lair - Escape From Singe's Castle
Dragons Lair & Escape (Fast)|Dragon's Lair & Escape From Singe's Castle (Fast)
Dragon Scape|DragonScape
Eagles Rider|Eagle's Rider
Elf Micro Value|Elf (MicroValue)
Elf Ocean|Elf (Ocean)
Elvira Arcade|Elvira - The Arcade Game
EMotion|E-Motion
Elvira|Elvira - Mistress of the Dark
Enforcer|Enforcer, The
Face Off|Face Off (Krisalis)
Encounter|Amiga Encounter
Emlyn Hughes Intl Soccer|Emlyn Hughes International Soccer
Enemy 2 Missing In Action|Enemy 2 - Missing In Action
Enemy TOVEasy Play|Enemy - Tempest Of Violence (Easy Play)
Enemy Tempest Of Violence|Enemy - Tempest Of Violence
Enemy - Easy Play|Enemy (Easy Play)
Entity No Intro|Entity (No Intro)
EOB1AGA|Eye of the Beholder [AGA]
EOB2AGA|Eye of the Beholder 2 [AGA]
Epic & Mission Disk|Epic (& Mission Disk)
England Champ Special|England Championship Special
Escape FTPOTRobot Monsters|Escape From The Planet Of The Robot Monsters
Espana The Games 92|Espana - The Games '92
ESWA T|ESWAT - Cyber Police
ETs Rugby League|E.T.'s Rugby League
European Champions Ocean|European Champions (Ocean)
Eye Of The Beholder 2|Eye Of The Beholder II - The Legend of Darkmoon
Fast Food Dizzy Collection|Fast Food (Dizzy Collection)
F 1|F1
F 1 Tornado|F1 Tornado
F 1 World Championship Ed|F1 World Championship Edition
F 15 Strike Eagle 2|F-15 Strike Eagle II
F 16 Combat Pilot|F-16 Combat Pilot
F 17 Challenge|F17 Challenge
F 19 Stealth Fighter|F-19 Stealth Fighter 
F 29 Retaliator|F-29 Retaliator
F 40 Pursuit Simulator|F40 Pursuit Simulator
Formula One 3 D|Formula 1 3D
Frontier|Frontier - Elite II
Foundations Waste|Foundation's Waste
FA 18 Interceptor|FA-18 Interceptor
Falcon & Mission Disks|Falcon (& Mission Disks)
Fatman Caped Consumer|Fatman - Caped Consumer
Fatman Caped Consumer [AGA]|Fatman - Caped Consumer [AGA]
Fate Gates Of Dawn|Fate - Gates Of Dawn
Femme Fatale & Data Disk|Femme Fatale (& Data Disk)
Fiendish Freddys Big Top OFun|Fiendish Freddy's Big Top O' Fun
Fighter Bomber A M|Fighter Bomber (Advanced Mission Disk)
Fightin Spirit|Fightin' Spirit
Five A Side Soccer|Five-a-Side Soccer
Flight Sim 2 & Scenery Disk 07|Flight Simulator II (& Scenery Disk 07)
Flight Sim 2 & Scenery Disk 09|Flight Simulator II (& Scenery Disk 09)
Flight Sim 2 & Scenery Disk 11|Flight Simulator II (& Scenery Disk 11)
Flight Sim 2 & Scenery Disk 12|Flight Simulator II (& Scenery Disk 12)
Flight Sim 2 & Scenery Disk 13|Flight Simulator II (& Scenery Disk 13)
Flight Sim 2 & Scenery Disk 14|Flight Simulator II (& Scenery Disk 14)
Flight Simulator 2|Flight Simulator II
Flight Simulator 2 & Hawaiian|Flight Simulator II (Hawaiian Odyssey)
Flight Sim 2|Flight Simulator II
Flimbos Quest|Flimbo's Quest
Flipit & Magnose|Flip-it & Magnose
Fools Errand|Fool's Errand
Freedom|Freedom - Rebels In The Darkness
Football Manager WCEd|Football Manager - World Cup Edition
Fuzzball No Intro|Fuzzball (No Intro)
Gadget Lost In Time|Gadget - Lost In Time
Galactic The Xmas Edition|Galactic - The Xmas Edition
Galaga 92|Galaga '92
Galdregons Domain|Galdregon's Domain
Games Summer Edition|Games - Summer Edition
Games Winter Edition|Games - Winter Edition
Garfield Big Fat Hairy Deal|Garfield - Big, Fat, Hairy Deal
Gary Linekers Hot Shot|Gary Lineker's Hot Shot
Gateway To Savage Frontier|Gateway To The Savage Frontier
GBA Championship BB|GBA Championship Basketball
Ghosts NGoblins|Ghosts 'n Goblins
Ghouls NGhosts|Ghouls 'n' Ghosts
Giddy 2 Hero In An Egg Shell|Giddy II - Hero In An Egg Shell
GLOCR 360|G-LOC R360
GNius|G.Nius
Goldrunner 2 & Scenery Disks|Goldrunner 2 (& Scenery Disks)
Goofys Railway Express|Goofy's Railway Express
Graeme Souness Soccer Managr|Graeme Souness Soccer Manager
Graham Gooch Second Innings|Graham Gooch's Second Innings
Graham Gooch WCCricket SE|Graham Gooch World Class Cricket Test Match Special Edition
Graham Gooch WCCricket|Graham Gooch World Class Cricket
Grannys Garden|Granny's Garden
GTSoccer Challenge|Graham Taylors Soccer Challenge
HA TE|H.A.T.E
Hacker 2|Hacker II
Hard Drivin|Hard Drivin'
Hard NHeavy|Hard 'n' Heavy
Hilt 2|Hilt II
Hard Ball 2|HardBall II
Hard Ball|HardBall
Hellbent|Hell Bent
Hilt|Hilt - Against the Hoardes
Hero Quest|HeroQuest
Hero Quest & Return Witch Lord|Hero Quest (& Return Of The Witch Lord)
Hell Raisers|Hell Raiser
Harpoon & Battleset 2|Harpoon (& Battleset 2)
Harpoon & Battleset 3|Harpoon (& Battleset 3)
Harpoon & Battleset 4|Harpoon (& Battleset 4)
Hitchhikers Guide TTG|Hitchhiker's Guide To The Galaxy
Hole In One & Data Disks|Hole In One (& Data Disks)
Hunt For Red October The Movie|Hunt For Red October (Grandslam)
Hunt For Red October|Hunt For Red October (Oxford Digital)
Ian Bothams Cricket|Ian Botham's Cricket
Indiana Jones Atlantis Act|Indiana Jones and the Fate of Atlantis (Action Game)
Indiana Jones Atlantis Adv|Indiana Jones and the Fate of Atlantis (Adventure Game)
Indiana Jones Last Crus Act|Indiana Jones and the Last Crusade (Action Game)
Indiana Jones Last Crus Adv|Indiana Jones and the Last Crusade (Adventure Game)
Indiana Jones Temple Of Doom|Indiana Jones and the Temple Of Doom
Ingrids Back|Ingrid's Back
Ishar|Ishar - Legend of the Fortress
Insector Hecti Inter Change|Insector Hecti in the Interchange
Int Sports Challenge|International Sports Challenge
Intact 15 MB|Intact (15 MB)
International 3 DTennis|International 3D Tennis
Interphase Amiga Format|Interphase (Amiga Format Edition)
Into The Eagles Nest|Into The Eagle's Nest
IK +|IK+
Italy 1990 Winners Edition|Italy 1990 - Winners Edition
Jabato|Jabato Vs Imperio Libertad
Jaguar XJ 220|Jaguar XJ220
Jaguar XJ 220 (Image)|Jaguar XJ220 (Image)
Jahangir Khans WChamp Squash|Jahangir Khan's World Championship Squash
James Bond The Stealth Affair|James Bond - The Stealth Affair
James Pond 2|James Pond 2 - Robocod
James Pond|James Pond - Underwater Agent 
Jet & Scenery Disk 07|Jet (& Scenery Disk 07)
Jet & Scenery Disk 09|Jet (& Scenery Disk 09)
Jet & Scenery Disk 11|Jet (& Scenery Disk 11)
Jet & Scenery Disk 12|Jet (& Scenery Disk 12)
Jet & Scenery Disk 13|Jet (& Scenery Disk 13)
Jet & Scenery Disk 14|Jet (& Scenery Disk 14)
Jet & Hawaiian Scenery|Jet (Hawaiian Odyssey)
Jimmy Whites Snooker|Jimmy White's Snooker
Jimmys Fantastic Journey|Jimmy's Fantastic Journey
Jocky Wilsons Dart Challenge|Jocky Wilson's Darts Challenge
John Barnes Euro Football|John Barnes European Football
Jump NRoll|Jump 'n' Roll
Jupiters Masterdrive|Jupiter's Masterdrive
K 240|K-240
K 2401 MB|K-240 (1MB)
Krusty's Super Fun House|Krusty's Fun House
Kajko IKokosz|Kajko i Kokosz
Kingpin 1 Mb|Kingpin (1MB)
Kings Quest|King's Quest
Kings Quest 2|King's Quest II
Kings Quest 3|King's Quest III
Kings Quest 4|King's Quest IV
Kings Quest 5|King's Quest V
Kings Quest 6|King's Quest VI
Kings Quest (Enhanced)|King's Quest I (Remake)
Kalas Puff Expressen Se (1MB)|Kalas Puff Expressen (Svenska) (1MB)
Kick Off 2 CV|Kick Off 2 (Competition Version)
Kick Off 2 Final Whistle CV|Kick Off 2 - Final Whistle (Competition Version)
Kick Off & Extra Time (1 Disk)|Kick Off (& Extra Time)
Kick Off 2 Plus WC 90|Kick Off 2 (Plus World Cup '90)
Kick Off 2 Return To Europe|Kick Off 2 - Return To Europe
Kick Off 3 EC|Kick Off 3 - European Challenge
Kick Off 216|Kick Off 2 (v1.6)
Kings Quest Enhanced|Kings Quest (Enhanced)
Kiros Quest|Kiro's Quest
Krustys Super Fun House|Krusty's Super Fun House
Lamborghini American Chllng|Lamborghini American Challenge
Leader Board TD 1|Leader Board (Tournament Disk 1)
Leading Lap MPVCUAmiga|Leading Lap MPV CU Amiga)
Leavin Teramis|Leavin' Teramis
LEDStorm|LED Storm
Legend Mindscape|Legend (Mindscape)
Lemmings 21 MB|Lemmings 2 (1MB)
Locomotion|Locomotion (Kingsoft)
Lords Of Chaos & Data Disk|Lords Of Chaos (& Data Disk)
Lotus|Lotus Esprit Turbo Challenge
Leonardo DOS|Leonardo (DOS)
Leonardo High Density|Leonardo (High Density)
Les Manley Search For The King|Les Manley In - Search For The King
Links & Data Disks|Links (& Data Disks)
Lombard RA CRally (2 Disk)|Lombard RAC Rally (2 Disk)
Lombard RA CRally (3 Disk)|Lombard RAC Rally (3 Disk)
Loom Kick 31|Loom (Kick 3.1)
Lothar Matthaus Fussball|Lothar Matthaus - Die Interaktive Fussballsimulation
M 1 Tank Platoon|M1 Tank Platoon
Magic Johnsons Basketball|Magic Johnson's Basketball
Magic Johnson Fst Brk Arcadia|Magic Johnson's Fast Break (Arcadia)
Magic Lines Cracked|Magic Lines (Cracked)
Manchester United Europe 23|Manchester United Europe (v2.3)
Manchester Utd PLC & Data|Manchester United Premier League Champions (& Data Disk)
Manchester United PLC|Manchester United Premier League Champions
Manchester United The Double|Manchester United - The Double
Manhunter|Manhunter - New York
Marias Xmas Box|Maria's Xmas Box
Mc Donald Land|McDonald Land
Mouse Quest|MouseQuest
Mental (Image) 1|Mental Image Game Disk 1
Mental (Image) 2|Mental Image Game Disk 2
Mercenary 3|Mercenary III
Mercenary|Mercenary - Escape from Targ and the Second City
MFTanks|MF Tanks
Mr Do Run Run (Files)|DO - Run Run (Files)
Mr Do Run Run (Image)|DO - Run Run (Image)
Mi G 29 Fulcrum|MiG-29 Fulcrum
Mi G 29 MSuper Fulcrum|MiG-29M Super Fulcrum
Mickey Mouse Computer Game|Mickey Mouse - The Computer Game
Mickeys A BC s|Mickey's ABC's
Mickeys A BCs|Mickey's ABC's
Mickeys Jigsaw Puzzles|Mickey's Jigsaw Puzzles
Mickeys Memory Challenge|Mickey's Memory Challenge
Micro Prose Golf|MicroProse Golf
Micro Prose Soccer|MicroProse Soccer
Mi G 29 Soviet Fighter|MIG 29 - Soviet Fighter
Might & Magic 2|Might and Magic II
Might And Magic 3|Might And Magic III
Mighty Bomb Jack|Mighty BombJack
Mike Reads Computer Pop Quiz|Mike Read's Computer Pop Quiz
Millennium 22|Millennium 2.2
Mortal Kombat 22 MB|Mortal Kombat 2 (2MB)
Mortal Kombat Censored|Mortal Kombat (Censored)
MPythons Flying Circus|Monty Python's Flying Circus
Monty Pythons Fly Cir|Monty Python's Flying Circus
MUDS|M.U.D.S
Myth History In The Making|Myth - History In The Making
Myth System 3|Myth - History In The Making
Myth Magnetic Scrolls|Myth (Magnetic Scrolls)
Ninja Mission Arcadia|Ninja Mission (Arcadia)
Nam 19651975|Nam 1965-1975
Never Ending Story 2|Neverending Story II
New Year Lemmings 199192|New Year Lemmings 1991-92
Nick Faldos Champ Golf|Nick Faldo's Championship Golf
Nigel Mansells Grand Prix|Nigel Mansell's Grand Prix
Night Hawk F 117 A|F-117A NightHawk Stealth Fighter
Nightbreed Action|Nightbreed - The Action Game
Nightbreed Movie|Nightbreed - The Interactive Movie
Operation Cleanstreets|Operation - Cleanstreets
Operation Combat 2|Operation Combat II
Ork Attack The Return|Ork Attack - The Return
Os WA LDOf The Ice Floes|OsWALD - Of The Ice Floes
Out Run Sega|Out Run (Sega)
Out Run USGold|Out Run (US Gold)
Overdrive Infacto|Overdrive (Infacto)
Overdrive Team 17|Overdrive (Team 17)
Overlord Rowan|Overlord (Rowan)
Overlander|Overlander (Elite)
on Escapee|onEscapee
P 47 Thunderbolt|P47 Thunderbolt
Pac Land|Pac-Land
Pac Mania|Pac-Mania
Paradroid 901 MB|Paradroid 90 (1MB)
Peter Beardsleys IFCracked|Peter Beardsley's International Football (Cracked)
Peter Beardsleys IF|Peter Beardsley's International Football
PGA Tour Golf & Tour Disk|PGA Tour Golf (& Tour Disk)
Pick NPile|Pick'n' Pile
Pharaohs Match Arcadia|Pharaohs Match (Arcadia)
Pierre Is Out To Lunch [AGA]|Pierre Le Chef Is Out To Lunch [AGA]
Pinball Fntsies|Pinball Fantasies
Pipeline Nomad|Pipeline (Nomad)
Pipeline Oracle|Pipeline (Oracle)
Populous & Data Disks|Populous (& Data Disks)
Populous 2 & Challenge Games|Populous 2 (& Challenge Games)
Populous World Editor|Populous - World Editor
Powermonger WW 1 Edition|Powermonger - WW1 Edition
PPHammer|P.P. Hammer
Premier Manager 3 Deluxe|Premier Manager 3 (Deluxe)
Pro Power Boat Simulator|Pro Powerboat Simulator
Project Xv 2|Project-X (v2)
Project XSE|Project-X (Special Edition)
Project X|Project-X
Project XBonus Level|Project-X (Bonus Level)
Pro Soccer 2190|ProSoccer 2190 
Robo Sport|RoboSport
Prophecy 1 Viking Child|Prophecy I - Viking Child
Puffys Saga|Puffy's Saga
QBic|Q-Bic
Quest For Glory 2|Quest For Glory II
Quik Thunder Rabbit|Quik - The Thunder Rabbit
Questron 2|Questron II
RType 2|R-Type II
RType|R-Type
Rackneys Island|Rackney's Island
Rage CA D|Rage (CAD)
Rage V 1|Rage (CAD)
Rage V 2|Rage (v2.0)
Ran X|Ranx
Road Wars Arcadia|Road Wars (Arcadia)
Rogue|Rogue - The Adventure Game
RBI 2 Baseball|R.B.I. Two Baseball
Rick Dangerous 25|Rick Dangerous 2.5
Robin Hood Legend Quest|Robin Hood - Legend Quest
Robinsons Requiem|Robinson's Requiem
Robo Cop|RoboCop
Robo Cop 2|RoboCop 2
Robo Cop 3|RoboCop 3
Robot Reader Aesops Fables|Robot Readers - Aesop's Fables
Robot Reader Chicken Little|Robot Readers - Chicken Little
Rock NRoll|Rock 'n' Roll
Rockstar NTRT|Rockstar - Never Trust Rotten Tangerines
Rod Land|Rod-Land
Rome A D 92|Rome AD92
Ruff NTumble|Ruff 'N' Tumble
RVFHonda|RVF Honda
SA SCombat Simulator QArcade|SAS Combat Simulator (Quattro Arcade)
SA SCombat Simulator QFight|SAS Combat Simulator (Quattro Fighters)
Salmon Pink Max|Salmon-Pink Max
Santas Xmas Caper|Santa's Xmas Caper
SDICinemaware|SDI (Cinemaware)
Sensible Soccer 9293|Sensible Soccer - European Champions (92-93 Edition)
Sensible Soccer 92931 MB|Sensible Soccer - European Champions (92-93 Edition) (1MB)
Sensible Soccer Bulldog Blty|Sensible Soccer 92-93 Meets Bulldog Blighty
Sensible Soccer Euro|Sensible Soccer - European Champions
Sensible Soccer Euro (1MB)|Sensible Soccer - European Champions (1MB)
Sensible Soccer Int Ed|Sensible Soccer - International Edition
Sensible Soccer Int Ed (1MB)|Sensible Soccer - International Edition (1MB)
Sensible World Of Soccer 9596|Sensible World Of Soccer 95-96
Sensible World Of Soccer 9697|Sensible World Of Soccer 96-97
Sensible World Of Soccer 9798|Sensible World Of Soccer 97-98
Sensible World Of Soccer 1617|Sensible World Of Soccer 16-17
Sensible World Of Soccer Euro|Sensible World Of Soccer 95-96 - European Championship Edition
Sensible World Of Soccer 11|Sensible World Of Soccer (v1.1)
Sensible World Of Soccer WC 98|Sensible World Of Soccer - World Cup 98
Sharkeys Moll|Sharkey's Moll
Shock Wave|ShockWave
Side Show|Sideshow
Sky Chase|SkyChase
Sherman M 4|Sherman M4
Side Winder 2|SideWinder II
Side Winder|SideWinder
Side Winder Arcadia|Side Winder (Arcadia)
Silent Service 2|Silent Service II
Sim Ant Hi Res|Sim Ant (HiRes)
Sim Ant Lo Res|Sim Ant (LoRes)
Sim City 12|Sim City (v1.2)
Sim Earth Hi Res|Sim Earth (HiRes)
Sim Earth Lo Res|Sim Earth (LoRes)
Skyfox 2|Skyfox II
Sleepwalker Comic Relief|Sleepwalker (Comic Relief)
Sleepwalker [AGA] Comic Relief|Sleepwalker (Comic Relief) [AGA]
Sly Spy Secret Agent|Sly Spy - Secret Agent
Sootys Fun With Numbers|Sooty's Fun With Numbers
Sorcerors Apprentice|Sorceror's Apprentice
Sorcery +|Sorcery+
Space Crusade & Voyage Beyond|Space Crusade (& The Voyage Beyond)
Space Harrier & Retrn Fnt Zone|Space Harrier (& Return to the Fantasy Zone)
Space Harrier & RFantasy Zone|Space Harrier (& Return to the Fantasy Zone)
Space Harrier 2|Space Harrier II
Space Quest Enhanced|Space Quest (Enhanced)
Speedboat Assassins|Speedboat Assassin
Spell Bound|Spell Bound (Psyclapse)
SpellBound|SpellBound (Pygnosis)
Spitting (Image)|Spitting Image
Spot Arcadia|Spot (Arcadia)
Spy Vs Spy 2 The Island Caper|Spy vs. Spy 2 - The Island Caper
Spy Vs Spy 3 Arctic Antics|Spy vs. Spy 3 - Arctic Antics
Spy Vs Spy|Spy vs. Spy
Stir Crazy Featuring Bobo|Bobo (Stir Crazy)
Stormlord Prerelease|Stormlord (Pre-release)
Spider Man|Spider-Man
Space Quest (Enhanced)|Space Quest I (Enhanced)
Space Quest 2|Space Quest II
Space Quest 3|Space Quest III
Space Quest 4|Space Quest IV
Strip Poker|Strip Poker (Artworx)
Strip Poker 2 + & Data Disk 1|Strip Poker II+ (& Data Disk 1)
Strip Poker 2 +|Strip Poker II+
Star Ray (2 Disk)|StarRay (2 Disk)
She Fox|She-Fox
Street Fighter 2|Street Fighter II - The World Warrior
Super Street Fighter 2|Super Street Fighter 2 - The New Challengers
STUNRunner|STUN Runner
Stunt Car Racer TNT|Stunt Car Racer - The New Tracks
Super Hang On|Super Hang-On
Super Off Road|Super Off Road
Super Seymour Saves Planet|Super Seymour Saves the Planet
Super Ski 2|Super Ski II
Subtrade|Sub Trade - Return To Irata
Supr Tennis Chmps & Data Disks|Super Tennis Champs (& Data Disks)
Supr Tennis Chmps|Super Tennis Champs
Super Seymour Saves the Planet|Super Seymour
Switchblade 2|Switchblade II
Take Em Out|Take 'Em Out
TBird|T-Bird
Teenage Mtnt Hero Turtles COp|Teenage Mutant Hero Turtles - The Coin-Op
Teenage Mtnt Hero Turtles|Teenage Mutant Hero Turtles
Teenage Mtnt Ninja Turtles|Teenage Mutant Ninja Turtles
Tennis Cup 1 Mb|Tennis Cup (1MB)
Terminator 2 Arcade Game|Terminator 2 - The Arcade Game
Terminator 2 Judgment Day|Terminator 2 - Judgment Day
Terrys Big Adventure|Terry's Big Adventure
Test Drive 2 & Data Disks|Test Drive 2 (& Data Disks)
Tennis Cup 2|Tennis Cup II
Tetris Infogrames|Tetris (Infogrames)
Tetris Mirrorsoft|Tetris (Mirrorsoft)
Their Finest Hour & Missions|Their Finest Hour (& Missions)
Thunder Cats|ThunderCats
Thunder Strike|ThunderStrike
Thunder Hawk A H 73 M|Thunder Hawk AH-73M
Time Runners Series|Time Runners (Series)
Tom Landry Football|Tom Landry Strategy Football
Tom Landry Football Deluxe|Tom Landry Strategy Football Deluxe
Tom Landry Strategy Football|Tom Landry Strategy Football Deluxe
Toyota Celica GTRally|Toyota Celica GT Rally
TRacer|T-Racer
Traps NTreasures|Traps 'n' Treasures
Trian GO|TrianGo
Trivial Pursuit New Begin|Trivial Pursuit - A New Beginning
Tubular Worlds ECS|Tubular Worlds
Turbo Trax Arcane|Turbo Trax (Arcane)
Turn NBurn|Turn 'n' Burn
Triple X|Tripple X
Toyota Celica GT Rally|Celica GT Rally
TVSports Baseball|TV Sports Baseball
TVSports Basketball|TV Sports Basketball
TVSports Boxing|TV Sports Boxing
TVSports Football|TV Sports Football
UMS 2 Nations At War|UMS II - Nations At War
Ultimate Golf|Greg Norman's Ultimate Golf
UFO Enemy Unknown|UFO - Enemy Unknown
Universal Military Sim|UMS (Universal Military Simulator)
UNSquadron|U.N. Squadron
UNSquadron Earok|U.N. Squadron (Hack by Earok)
Untouchables SE|Untouchables Special Edition (Hack by Earok)
Up Scope Arcadia|Up Scope (Arcadia)
Uridium 22 MB|Uridium 2 (2MB)
USSJohn Young|USS John Young
Utopia & New Worlds|Utopia (& New Worlds)
Venus The Flytrap No Intro|Venus The Flytrap (No Intro)
Vroom & Data Disk|Vroom (& Data Disk)
Vroom Multi Player|Vroom (Multi Player)
Valhalla Before The War|Valhalla - Before The War
Valhalla Lord Of Infinity|Valhalla and the Lord Of Infinity
Vampires Empire|Vampire's Empire
Walker Decrunched|Walker (Decrunched)
War Zone Core|War Zone (Core Design)
War Zone Core Design|War Zone (Core Design)
War Zone Paradox|War Zone (Paradox)
Wanderer 3 D|Wanderer 3D
Way Of The Little Dragon A Star|Way Of The Little Dragon (Amiga Star Collection)
WCLeader Board & Data Disks|World Class Leader Board (& Data Disks)
WCLeader Board|World Class Leader Board
Wembley Int Soccer|Wembley International Soccer
Whirligig Cracked|Whirligig (Cracked)
WIEurope Is Carmen Sandiego|Where in Europe is Carmen Sandiego
WITUSA Is Carmen Sandiego|Where in the USA is Carmen Sandiego
WITWIs Carmen Sandiego|Where in The World is Carmen Sandiego
Wiz NLiz|Wiz 'n' Liz
Wizardry 6 Bane Cosmic Forg|Wizardry - Bane of the Cosmic Forge 
Woodys World|Woody's World
Wonderland|Wonderland - Dream the Dream
World Champ Boxing Manager|World Championship Boxing Manager
World Class Rugby 95|World Class Rugby '95
World Class Rugby 5 Nations|World Class Rugby - 5 Nations
World Darts Arcadia|World Darts (Arcadia)
WWFEuropean Rampage Tour|WWF European Rampage Tour
WWFWrestle Mania|WWF Wrestle Mania
Xenon 21 Disk|Xenon 2 (1 Disk)
Xenon 22 Disk|Xenon 2 (2 Disk)
Xenon Arcadia|Xenon (Arcadia)
West Phaser|Westphaser
XP 8|XP8
XR 35|XR35
XR35|XR-35 Fighter Mission
XOut|X-Out
XOut (2 Disk)|X-Out (2 Disk)
XIt|X-It
Yogis Big Clean Up|Yogi's Big Clean Up
Yogis Great Escape|Yogi's Great Escape
Zak Mc Kracken|Zak McKracken
ZOut|Z-Out
Alien Breed 3 DCD32|Alien Breed 3D [CD32]
Alien Breed TA [CD32]|Alien Breed Tower Assault [CD32]
Roadkill [CD32] No Intro|Roadkill [CD32] (No Intro
Beneath A Stl Sky [CD32] No Voice|Beneath A Steel Sky [CD32] (No Voice)
Beneath A Stl Sky [CD32]|Beneath A Steel Sky [CD32]
Bomb Pac [CD32] [AGA] Aminet|Bomb Pac [CD32] [AGA] (Aminet)
Bubba NStix [CD32]|Bubba'N'Stix [CD32]
Bump NBurn [CD32]|Bump 'N' Burn [CD32]
DGeneration [CD32]|D-Generation [CD32]
Extractors Preview [CD32]|Extractors (Preview) [CD32]
Frontier [CD32]|Frontier - Elite 2 [CD32]
Marvins Marvellous Adv [CD32]|Marvin's Marvellous Adventure [CD32]
Myth History In Making [CD32]|Myth - History In Making [CD32]
Nick Faldos Champ Golf [CD32]|Nick Faldo's Championship Golf [CD32]
Nigel Mansells Wrld Chmp [CD32]|Nigel Mansell's World Championship [CD32]
Pinball Fntsies [CD32] (Chip)|Pinball Fantasies [CD32] (Chip)
Pinball Fntsies [CD32]|Pinball Fantasies [CD32]
Quik Thunder Rabbit [CD32]|Quik - The Thunder Rabbit [CD32]
Sensible Soccer Intl Ed [CD32]|Sensible Soccer - International Edition [CD32]
Supr Strt Ftr 2 Trbo [CD32]|Super Street Fighter 2 Turbo [CD32]
Thomas Tank Eng Pinball [CD32]|Thomas the Tank Engine Pinball [CD32]
UFOEnemy Unknown [CD32]|UFO - Enemy Unknown [CD32]
Worms [CD32]1 MB|Worms [CD32] (1 MB)
Worms [CD32]2 MB|Worms [CD32] (2 MB)
Street Racer [CD32]|Street Racer (AmigaCD)
Project XSECD32|Project X - Special Edition [CD32]
A CSYSDemo [AGA]|ACSYS - Autonomous Cybernetic System (Demo) [AGA]
Alien Breed 3 D 2 [AGA]|Alien Breed 3D 2 - The Killing Grounds [AGA]
Alien Breed 3 D 2 [AGA] 4MB|Alien Breed 3D 2 - The Killing Grounds [4MB] [AGA]
Alien Breed 3 DAGA Fixed|Alien Breed 3D [AGA] (Fixed)
Alien Breed 3 DAGA|Alien Breed 3D [AGA]
Alien Breed TA [AGA]|Alien Breed - Tower Assault [AGA]
Alien Breed TA 11|Alien Breed - Tower Assault (v1.1)
Alien Breed TA 11 [AGA]|Alien Breed - Tower Assault (v1.1) [AGA]
Charlie JCool [AGA]|Charlie J Cool [AGA]
Dennis [AGA] Desktop Dynamite|Dennis [AGA] (Desktop Dynamite)
Dream Web [AGA]|DreamWeb [AGA]
James Pond 2 [AGA]|James Pond 2 - Robocod [AGA]
James Pond 3 [AGA]|James Pond 3 - Operation Starfish [AGA]
Kick Off 3 EC_ [AGA]|Kick Off 3 - European Challenge [AGA]
Leading Lap MPVAGA|Leading Lap (MPV) [AGA]
Penthouse Hot Nums Dlx [AGA] De|Penthouse Hot Numbers Deluxe [AGA] (Deutsch)
Penthouse Hot Nums Dlx [AGA] (Deutsch)|Penthouse Hot Numbers Deluxe [AGA] (Deutsch)
Pinball Fntsies [AGA]|Pinball Fantasies [AGA]
Thomas Tank Eng Pinball [AGA]|Thomas the Tank Engine Pinball [AGA]
UFOEnemy Unknown [AGA]|UFO - Enemy Unknown [AGA]
Wembley Int Soccer [AGA]|Wembley International Soccer [AGA]
XTreme Racing & Data Disks [AGA]|XTreme Racing (& Data Disks) [AGA]
Supr Strt Ftr 2 Trbo [AGA]|Super Street Fighter 2 Turbo [AGA]
Super Street Fighter 2 DXAGA|Super Street Fighter 2 (DX) [AGA]
Star Trek 25th Anniv [AGA]|Star Trek - 25th Anniversary [AGA]
Robinsons Requiem [AGA]|Robinson's Requiem [AGA]
Quik Thunder Rabbit [AGA]|Quik - The Thunder Rabbit [AGA]
DGeneration [AGA]|D-Generation [AGA]
Ishar [AGA]|Ishar - Legend of the Fortress [AGA]
Nigel Mansells Wrld Chmp [AGA]|Nigel Mansell's World Championship [AGA]
Pulsator Demo [AGA]|Pulsator (Demo) [AGA]
Marvins Marvellous Adv [AGA]|Marvin's Marvellous Adventure [AGA]
XP 8 [AGA]|XP8 [AGA]
Agony Demo|Agony (Demo)
Alchemy Demo|Alchemy (Demo)
All Terrain Racing Xmas Demo|ATR - All Terrain Racing (Xmas Demo)
Awesome Demo|Awesome (Demo)
Alien Breed 3 DDemo Latest [AGA]|Alien Breed 3D (Demo) (Latest) [AGA]
Alien Breed 3 DDemo Play [AGA]|Alien Breed 3D (Playable Demo) [AGA]
Alien Breed 3 DDemo Roll [AGA]|Alien Breed 3D (Rolling Demo) [AGA]
B 17 Flying Fortress Demo|B 17 Flying Fortress (Demo)
Babylonian Twins Demo|Babylonian Twins (Demo)
Basket Island Demo 1 [AGA]|Basket Island (Demo 1) [AGA]
Basket Island Demo 1|Basket Island (Demo 1)
Basket Island Demo 2 [AGA]|Basket Island (Demo 2) [AGA]
Basket Island Demo 2|Basket Island (Demo 2)
Battle Squadron Demo|Battle Squadron (Demo)
Breathless Demo [AGA]|Breathless (Demo) [AGA]
Breathless Demo|Breathless (Demo)
Cadaver Demos|Cadaver (Demos)
Chaos Engine Demo|Chaos Engine (Demo)
Daley Thompsons OC (1 Disk)|Daley Thompson's Olympic Challenge (1 Disk)
Damage (Preview)|Damage (Preview)
Dragons Kingdom Demo|Dragons Kingdom (Demo)
Dragons Lair Escape Demo NTSC|Dragons Lair Escape (Demo) (NTSC)
Evils Doom Demo|Evils Doom (Demo)
Fire & Ice Xmas Demo|Fire and Ice (Christmas Special Edition)
Gloom Demo|Gloom (Demo)
Gods Demo|Gods (Demo)
Hired Guns Demo (1MB)|Hired Guns (Demo) (1MB)
Hired Guns Demo 512 KB|Hired Guns (Demo) (512KB)
King Pin Demo|King Pin (Demo)
Lemmings 2 Demo|Lemmings 2 (Demo)
Lemmings Demo|Lemmings (Demo)
Lemmings Holiday Demo|Lemmings Holiday (Demo)
Lionheart Demo (1MB)|Lionheart (Demo) (1MB)
Lionheart Demo 1|Lionheart (Demo 1)
Lionheart Demo 2|Lionheart (Demo 2)
Lionheart Demo|Lionheart (Demo)
Magic Pockets Demo|Magic Pockets (Demo)
New Zealand Story Demo|New Zealand Story (Demo)
Nuxelia Demo|Nuxelia (Demo)
Operation G 2 Demo|Operation GII (Demo)
Ork Demo|Ork (Demo)
Overlord Demo Rowan|Overlord (Rowan)(Demo) 
Pinball Illusions [AGA] Demo|Pinball Illusions (Demo) [AGA]
Pulsator Demo|Pulsator (Demo)
Putty Squad Demo [AGA]|Putty Squad (Demo) [AGA]
Shadow Of The Beast 2 Demo|Shadow Of The Beast 2 (Demo)
Shadow Of The Beast Demo|Shadow Of The Beast (Demo)
Slam Tilt Demo [AGA]|Slam Tilt (Demo) [AGA]
Space Ace Demo|Space Ace (Demo)
Superfrog Demo Amiga Action|Superfrog (Demo) Amiga Action
Superfrog Demo CUAmiga|Superfrog (CU Amiga Demo)
Superfrog Demo The One|Superfrog (The One Demo) 
Superhero Demo|Superhero (Demo)
T-Zer 0 Demo|T-Zer0 (Demo)
T-Zer 0 Demo [AGA]|T-Zer0 (Demo) [AGA]
TZer 0 Demo [AGA]|T-Zer0 (Demo) [AGA]
Tensai Demo|Tensai (Demo)
Turrican 2 Demo|Turrican 2 (Demo)
Turrican 3 Demo|Turrican 3 (Demo)
Turrican Demo|Turrican (Demo)
Virtual Karting 2 Demo [AGA]|Virtual Karting 2 (Demo) [AGA]
Virtual Karting Demo [AGA]|Virtual Karting (Demo) [AGA]
Wrath Of The Demon|Wrath Of The Demon
Xenon 2 Demo|Xenon 2 (Demo)
Xmas Lemmings Demo 1991|Xmas Lemmings (1991 Demo)
Xmas Lemmings Demo 1992|Xmas Lemmings (1992 Demo)
Yo Joe Demo|Yo Joe (Demo)
